23,153,142,29,176,61,56,186
786,121,877,30,910,62,818,154
197,270,302,270,302,412,197,412
1134,508,1245,398,1275,428,1164,539
666,453,680,406,876,466,862,513
753,493,792,493,792,550,753,550
910,565,924,514,1033,545,1018,596
53,854,144,763,176,796,86,886
790,851,878,762,912,796,823,884
